<Map3D name="stage_1">
<Chunk position="-1,-1">
<Tiles height="0">
53,53,53,53,53,53,53,53,53,53,53,0,0,0,0,0,
0,0,0,0,0,0,0,0,0,0,0,0,0,0,0,0,
0,0,0,0,0,0,0,0,0,0,0,0,0,0,0,0,
0,0,0,0,0,0,0,0,0,0,0,0,0,0,0,0,
0,0,0,0,0,0,0,0,0,0,0,0,0,0,0,0,
0,0,0,0,0,0,0,0,0,0,0,0,0,0,0,0,
0,0,0,0,0,0,0,0,0,0,0,0,0,0,0,0,
0,0,0,0,0,0,0,0,0,0,0,0,0,0,0,0,
0,0,0,0,0,0,0,0,0,0,0,0,0,0,0,0,
0,0,0,0,0,0,0,0,0,0,0,0,0,0,0,0,
0,0,0,0,0,0,0,0,0,0,0,0,0,0,0,0,
0,0,0,0,0,0,0,0,0,0,0,0,0,0,0,0,
0,0,0,0,0,0,0,0,0,0,0,0,0,0,0,0,
0,0,0,0,0,0,0,0,0,0,0,0,0,0,0,0,
0,0,0,0,0,0,0,0,0,0,0,0,0,0,0,0,
0,0,0,0,0,0,0,0,0,0,0,0,0,0,0,0
</Tiles>
</Chunk>
<Chunk position="0,0">
<Tiles height="0">
0,0,0,0,0,0,0,0,0,0,0,0,0,0,0,0,
0,0,0,0,0,0,0,0,0,0,0,0,0,0,0,0,
0,0,0,0,0,0,0,0,0,0,0,0,0,0,0,0,
0,0,0,0,0,0,0,0,0,0,0,0,0,0,0,0,
0,0,0,0,0,0,0,0,0,0,0,0,0,0,0,0,
0,0,0,0,0,0,0,0,0,0,0,0,0,0,0,0,
0,0,0,0,0,0,0,0,0,0,0,0,0,0,0,0,
0,0,0,0,0,0,0,0,0,0,0,0,0,0,0,0,
22,28,22,25,22,22,22,22,22,22,22,22,22,22,22,22,
1,1,1,1,1,1,9,9,9,9,1,1,45,1,1,11,
1,1,1,1,1,1,9,9,9,9,1,1,1,1,1,12,
1,1,1,1,1,1,9,9,9,9,1,1,1,1,1,11,
1,1,1,1,1,1,9,9,9,9,1,1,1,1,1,12,
1,1,1,1,1,1,9,9,9,9,1,1,1,1,1,11,
1,1,1,1,1,1,9,9,9,9,1,1,1,1,1,12,
1,1,1,1,1,1,9,9,9,9,1,1,1,1,1,11
</Tiles>
<Tiles height="2">
0,0,0,0,0,0,0,0,0,0,0,0,0,0,0,0,
0,0,0,0,0,0,0,0,0,0,0,0,0,0,0,0,
0,0,0,0,0,0,0,0,0,0,0,0,0,0,0,0,
0,0,0,0,0,0,0,0,0,0,0,0,0,0,0,0,
0,0,0,0,0,0,0,0,0,0,0,0,0,0,0,0,
0,0,0,0,0,0,0,0,0,0,0,0,0,0,0,0,
0,0,0,0,0,0,0,0,0,0,0,0,0,0,0,0,
0,0,0,0,0,0,0,0,0,0,0,0,0,0,0,0,
53,53,53,53,53,53,53,53,53,53,53,53,53,53,53,53,
0,0,0,0,0,0,0,0,0,0,0,0,0,0,0,0,
0,0,0,0,0,0,0,0,0,0,0,0,0,0,0,0,
0,0,0,0,0,0,0,0,0,0,0,0,0,0,0,0,
0,0,0,0,0,0,0,0,0,0,0,0,0,0,0,0,
0,0,0,0,0,0,0,0,0,0,0,0,0,0,0,0,
0,0,0,0,0,0,0,0,0,0,0,0,0,0,0,0,
0,0,0,0,0,0,0,0,0,0,0,0,0,0,0,0
</Tiles>
<Tiles height="1">
0,0,0,0,0,0,0,0,0,0,0,0,0,0,0,0,
0,0,0,0,0,0,0,0,0,0,0,0,0,0,0,0,
0,0,0,0,0,0,0,0,0,0,0,0,0,0,0,0,
0,0,0,0,0,0,0,0,0,0,0,0,0,0,0,0,
0,0,0,0,0,0,0,0,0,0,0,0,0,0,0,0,
0,0,0,0,0,0,0,0,0,0,0,0,0,0,0,0,
0,0,0,0,0,0,0,0,0,0,0,0,0,0,0,0,
0,0,0,0,0,0,0,0,0,0,0,0,0,0,0,0,
22,22,22,22,22,22,22,22,22,22,22,22,22,22,22,22,
0,0,0,0,0,0,0,0,0,0,0,0,0,0,0,0,
0,0,0,0,0,0,0,0,0,0,0,0,0,0,0,0,
0,0,0,0,0,0,0,0,0,0,0,0,0,0,0,0,
0,0,0,0,0,0,0,0,0,0,0,0,0,0,0,0,
0,0,0,0,0,0,0,0,0,0,0,0,0,0,0,0,
0,0,0,0,0,0,0,0,0,0,0,0,0,0,0,0,
0,0,0,0,0,0,0,0,0,0,0,0,0,0,0,0
</Tiles>
<Tiles height="-1">
0,0,0,0,0,0,0,0,0,0,0,0,0,0,0,0,
0,0,0,0,0,0,0,0,0,0,0,0,0,0,0,0,
0,0,0,0,0,0,0,0,0,0,0,0,0,0,0,0,
0,0,0,0,0,0,0,0,0,0,0,0,0,0,0,0,
0,0,0,0,0,0,0,0,0,0,0,0,0,0,0,0,
0,0,0,0,0,0,0,0,0,0,0,0,0,0,0,0,
0,0,0,0,0,0,0,0,0,0,0,0,0,0,0,0,
0,0,0,0,0,0,0,0,0,0,0,0,0,0,0,0,
0,0,0,0,0,0,30,30,30,30,0,0,30,0,0,30,
0,0,0,0,0,0,0,0,0,0,0,0,0,0,0,0,
0,0,0,0,0,0,0,0,0,0,0,0,0,0,0,0,
0,0,0,0,0,0,0,0,0,0,0,0,0,0,0,0,
0,0,0,0,0,0,0,0,0,0,0,0,0,0,0,0,
0,0,0,0,0,0,0,0,0,0,0,0,0,0,0,0,
0,0,0,0,0,0,0,0,0,0,0,0,0,0,0,0,
0,0,0,0,0,0,0,0,0,0,0,0,0,0,0,0
</Tiles>
</Chunk>
<Chunk position="1,0">
<Tiles height="2">
0,0,0,0,0,0,0,0,0,0,0,0,0,0,0,0,
0,0,0,0,0,0,0,0,0,0,0,0,0,0,0,0,
0,0,0,0,0,0,0,0,0,0,0,0,0,0,0,0,
0,0,0,0,0,0,0,0,0,0,0,0,0,0,0,0,
0,0,0,0,0,0,0,0,0,0,0,0,0,0,0,0,
0,0,0,0,0,0,0,0,0,0,0,0,0,0,0,0,
0,0,0,0,0,0,0,0,0,0,0,0,0,0,0,0,
0,0,0,0,0,0,0,0,0,0,0,0,0,0,0,0,
0,0,0,0,0,0,0,0,0,0,0,0,0,0,0,0,
0,0,0,0,0,0,0,0,0,0,0,0,0,0,0,0,
0,0,0,0,0,0,0,0,0,0,0,0,0,0,0,0,
0,0,0,0,0,0,0,0,0,0,0,0,0,0,0,0,
0,0,0,0,0,0,0,0,0,0,0,0,0,0,0,0,
0,0,0,0,0,0,0,0,0,0,0,0,0,0,0,0,
0,0,0,0,0,0,0,0,0,0,0,0,0,0,0,0,
0,0,0,0,0,0,0,0,0,0,0,0,0,0,0,0
</Tiles>
<Tiles height="1">
0,0,0,0,0,0,0,0,0,0,0,0,0,0,0,0,
0,0,0,0,0,0,0,0,0,0,0,0,0,0,0,0,
0,0,0,0,0,0,0,0,0,0,0,0,0,0,0,0,
0,0,0,0,0,0,0,0,0,0,0,0,0,0,0,0,
0,0,0,0,0,0,0,0,0,0,0,0,0,0,0,0,
0,0,0,0,0,0,0,0,0,0,0,0,0,0,0,0,
0,0,0,0,0,0,0,0,0,0,0,0,0,0,0,0,
0,0,0,0,0,0,0,0,0,0,0,0,0,0,0,0,
0,0,0,0,0,0,0,0,0,0,0,0,0,0,0,0,
0,0,0,0,0,0,0,0,0,0,0,0,0,0,0,23,
0,0,0,0,0,0,0,0,0,0,0,0,0,0,0,23,
0,0,0,0,0,0,0,0,0,0,0,0,0,0,0,23,
0,0,0,0,0,0,0,0,0,0,0,0,0,0,0,23,
0,0,0,0,0,0,0,0,0,0,0,0,0,0,0,23,
0,0,0,0,0,0,0,0,0,0,0,0,0,0,0,23,
0,0,0,0,0,0,0,0,0,0,0,0,0,0,0,23
</Tiles>
<Tiles height="0">
0,0,0,0,0,0,0,0,0,0,0,0,0,0,0,0,
0,0,0,0,0,0,0,0,0,0,0,0,0,0,0,0,
0,0,0,0,0,0,0,0,0,0,0,0,0,0,0,0,
0,0,0,0,0,0,0,0,0,0,0,0,0,0,0,0,
0,0,0,0,0,0,0,0,0,0,0,0,0,0,0,0,
0,0,0,0,0,0,0,0,0,0,0,0,0,0,0,0,
0,0,0,0,0,0,0,0,0,0,0,0,0,0,0,0,
0,0,0,0,0,0,0,0,0,0,0,0,0,0,0,0,
0,0,0,0,0,0,0,0,0,0,0,0,0,0,0,0,
0,0,0,0,0,0,0,0,0,0,0,0,0,0,0,23,
0,0,0,0,0,0,0,0,0,0,0,0,0,0,0,23,
0,0,0,0,0,0,0,0,0,0,0,0,0,0,0,23,
0,0,0,0,0,0,0,0,0,0,0,0,0,0,0,23,
0,0,0,0,0,0,0,0,0,0,0,0,0,0,0,23,
0,0,0,0,0,0,0,0,0,0,0,0,0,0,0,23,
0,0,0,0,0,0,0,0,0,0,0,0,0,0,0,23
</Tiles>
</Chunk>
<Chunk position="0,1">
<Tiles height="0">
0,0,0,0,0,0,0,0,0,0,0,0,0,0,0,0,
0,0,0,0,0,0,0,0,0,0,0,0,0,0,0,0,
0,0,0,0,0,0,0,0,0,0,0,0,0,0,0,0,
0,0,0,0,0,0,0,0,0,0,0,0,0,0,0,0,
0,0,0,0,0,0,0,0,0,0,0,0,0,0,0,0,
0,0,0,0,0,0,0,0,0,0,0,0,0,0,0,0,
0,0,0,0,0,0,0,0,0,0,0,0,0,0,0,0,
0,0,0,0,0,0,0,0,0,0,0,0,0,0,0,0,
0,0,0,0,0,0,0,0,0,0,0,0,0,0,0,0,
0,0,0,0,0,0,0,0,0,0,0,0,0,0,0,0,
0,0,0,0,0,0,0,0,0,0,0,0,0,0,0,0,
0,0,0,0,0,0,0,0,0,0,0,0,0,0,0,0,
0,0,0,0,0,0,0,0,0,0,0,0,0,0,0,0,
0,0,0,0,0,0,0,0,0,0,0,0,0,0,0,0,
0,0,0,0,0,0,0,0,0,0,0,0,0,0,0,0,
0,0,0,0,0,0,0,0,0,0,0,0,0,0,0,0
</Tiles>
<Tiles height="1">
0,0,0,0,0,0,0,0,0,0,0,0,0,0,0,0,
0,0,0,0,0,0,0,0,0,0,0,0,0,0,0,0,
0,0,0,0,0,0,0,0,0,0,0,0,0,0,0,0,
0,0,0,0,0,0,0,0,0,0,0,0,0,0,0,0,
0,0,0,0,0,0,0,0,0,0,0,0,0,0,0,0,
0,0,0,0,0,0,0,0,0,0,0,0,0,0,0,0,
0,0,0,0,0,0,0,0,0,0,0,0,0,0,0,0,
0,0,0,0,0,0,0,0,0,0,0,0,0,0,0,0,
0,0,0,0,0,0,0,0,0,0,0,0,0,0,0,0,
0,0,0,0,0,0,0,0,0,0,0,0,0,0,0,0,
0,0,0,0,0,0,0,0,0,0,0,0,0,0,0,0,
0,0,0,0,0,0,0,0,0,0,0,0,0,0,0,0,
0,0,0,0,0,0,0,0,0,0,0,0,0,0,0,0,
0,0,0,0,0,0,0,0,0,0,0,0,0,0,0,0,
0,0,0,0,0,0,0,0,0,0,0,0,0,0,0,0,
0,0,0,0,0,0,0,0,0,0,0,0,0,0,0,0
</Tiles>
</Chunk>
<Chunk position="0,-1">
<Tiles height="0">
53,53,53,53,53,53,53,53,53,53,53,53,53,53,53,53,
0,0,0,0,0,0,0,0,0,0,0,0,0,0,0,0,
0,0,0,0,0,0,0,0,0,0,0,0,0,0,0,0,
0,0,0,0,0,0,0,0,0,0,0,0,0,0,0,0,
0,0,0,0,0,0,0,0,0,0,0,0,0,0,0,0,
0,0,0,0,0,0,0,0,0,0,0,0,0,0,0,0,
0,0,0,0,0,0,0,0,0,0,0,0,0,0,0,0,
0,0,0,0,0,0,0,0,0,0,0,0,0,0,0,0,
0,0,0,0,0,0,0,0,0,0,0,0,0,0,0,0,
0,0,0,0,0,0,0,0,0,0,0,0,0,0,0,0,
0,0,0,0,0,0,0,0,0,0,0,0,0,0,0,0,
0,0,0,0,0,0,0,0,0,0,0,0,0,0,0,0,
0,0,0,0,0,0,0,0,0,0,0,0,0,0,0,0,
0,0,0,0,0,0,0,0,0,0,0,0,0,0,0,0,
0,0,0,0,0,0,0,0,0,0,0,0,0,0,0,0,
0,0,0,0,0,0,0,0,0,0,0,0,0,0,0,0
</Tiles>
</Chunk>
<Chunk position="-1,0">
<Tiles height="2">
0,53,53,53,53,0,53,53,53,53,0,0,0,0,0,0,
0,53,53,0,53,0,53,0,53,53,0,0,0,0,0,0,
0,53,53,0,53,0,53,0,53,53,0,0,0,0,0,0,
0,53,0,0,0,0,0,0,0,0,53,0,0,0,0,0,
0,53,0,0,0,0,0,0,0,0,53,0,0,0,0,0,
0,53,0,0,0,0,0,0,0,0,53,0,0,0,0,0,
0,53,53,53,53,53,53,53,53,0,53,0,0,0,0,0,
0,0,53,53,53,53,53,53,53,0,53,0,0,0,0,0,
53,53,53,53,53,53,53,53,53,0,53,0,0,0,0,0,
0,0,0,0,0,0,0,53,53,0,53,0,0,0,0,0,
0,0,0,0,0,0,0,53,0,0,0,0,0,0,0,0,
0,0,0,0,0,0,0,53,53,0,53,0,0,0,0,0,
0,0,0,0,0,0,0,53,0,0,0,0,0,0,0,0,
0,0,0,0,0,0,0,53,53,0,53,0,0,0,0,0,
0,0,0,0,0,0,0,0,0,0,0,0,0,0,0,0,
0,0,0,0,0,0,0,0,0,0,0,0,0,0,0,0
</Tiles>
<Tiles height="0">
0,0,0,50,23,1,21,50,0,0,0,0,0,0,0,0,
0,0,23,1,21&23,1,21&23,1,21,0,0,0,0,0,0,0,
0,0,22&23,1&27,21&23&48,1,22&21&23,1&27,22&21,22,0,0,0,0,0,0,
0,23,1,1,1,1,1,1,1,1,21,0,0,0,0,0,
0,23,1,1,1,1,1,1,1,1,21,0,0,0,0,0,
0,23,1,1,1,1,1,1,1,1,21,0,0,0,0,0,
0,0,0,0,0,0,0,0,23,1,21,0,0,0,0,0,
0,0,0,0,0,0,0,0,23,1,21,0,0,0,0,0,
22,22,22,22,22,22,22,22,22&23,1,22&21,0,0,0,0,0,
12,11,12,11,12,11,12,21,46&23,1&27,50&21,0,0,0,0,0,
11,12,11,12,11,12,11,21&23,1,1,1,21,0,0,0,0,
12,11,12,11,12,11,12,21,46&23,1&27,48&21,0,0,0,0,0,
11,12,11,12,11,12,11,21&23,1,1,1,21,0,0,0,0,
12,11,12,11,12,11,12,21&22,46&23,1&27,21&22,0,0,0,0,0,
11,12,11,12,11,12,11,1,1,1,1,21,0,0,0,0,
12,11,12,11,12,11,12,1,1,1,1,21,0,0,0,0
</Tiles>
<Tiles height="1">
0,0,0,22,23,0,21,22,0,0,0,0,0,0,0,0,
0,0,23,0,21&23,0,21&23,0,21,0,0,0,0,0,0,0,
0,0,22&23,22,22&21&23,0,22&21&23,22,22&21,22,0,0,0,0,0,0,
0,23,0,0,0,0,0,0,0,0,21,0,0,0,0,0,
0,23,0,0,0,0,0,0,0,0,21,0,0,0,0,0,
0,23,0,0,0,0,0,0,0,0,21,0,0,0,0,0,
0,0,0,0,0,0,0,0,23,0,21,0,0,0,0,0,
0,0,0,0,0,0,0,0,23,0,21,0,0,0,0,0,
22,22,22,22,22,22,22,22,22&23,0,22&21,0,0,0,0,0,
0,0,0,0,0,0,0,21,22&23,22,21&22,0,0,0,0,0,
0,0,0,0,0,0,0,21&23,0,0,0,21,0,0,0,0,
0,0,0,0,0,0,0,21,22&23,22,21&22,0,0,0,0,0,
0,0,0,0,0,0,0,21&23,0,0,0,21,0,0,0,0,
0,0,0,0,0,0,0,21&22,22&23,22,21&22,0,0,0,0,0,
0,0,0,0,0,0,0,0,0,0,0,21,0,0,0,0,
0,0,0,0,0,0,0,0,0,0,0,21,0,0,0,0
</Tiles>
<Tiles height="-1">
0,0,0,0,0,0,0,0,0,0,0,0,0,0,0,0,
0,0,0,0,0,0,0,0,0,0,0,0,0,0,0,0,
0,0,0,0,0,0,0,0,0,0,0,0,0,0,0,0,
0,0,0,0,0,0,0,0,0,0,0,0,0,0,0,0,
0,0,0,0,0,0,0,0,0,0,0,0,0,0,0,0,
0,0,0,0,0,0,0,0,0,0,0,0,0,0,0,0,
0,0,0,0,0,0,0,0,0,0,0,0,0,0,0,0,
0,0,0,0,0,0,0,0,0,0,0,0,0,0,0,0,
30,30,30,30,30,30,30,0,0,0,0,0,0,0,0,0,
0,0,0,0,0,0,0,21,0,0,0,0,0,0,0,0,
0,0,0,0,0,0,0,21,0,0,0,0,0,0,0,0,
0,0,0,0,0,0,0,21,0,0,0,0,0,0,0,0,
0,0,0,0,0,0,0,21,0,0,0,0,0,0,0,0,
0,0,0,0,0,0,0,21,0,0,0,0,0,0,0,0,
0,0,0,0,0,0,0,21,0,0,0,0,0,0,0,0,
0,0,0,0,0,0,0,21,0,0,0,0,0,0,0,0
</Tiles>
</Chunk>
<Chunk position="-1,1">
<Tiles height="2">
0,0,0,0,0,0,0,0,0,0,0,0,0,0,0,0,
0,0,0,0,0,0,0,0,0,0,0,0,0,0,0,0,
0,0,0,0,0,0,0,0,0,0,0,0,0,0,0,0,
0,0,0,0,0,0,0,0,0,0,0,0,0,0,0,0,
0,0,53,0,0,0,0,0,0,0,0,0,0,0,0,0,
0,0,53,0,0,0,0,0,0,0,0,0,0,0,0,0,
0,0,53,0,0,53,53,53,53,53,0,0,0,0,0,0,
0,0,53,0,0,53,53,53,53,53,0,0,0,0,0,0,
0,0,53,0,0,53,53,53,53,53,0,0,0,0,0,0,
0,53,53,0,0,53,53,53,53,53,0,0,0,0,0,0,
0,53,0,0,0,0,53,53,53,53,0,0,0,0,0,0,
0,53,0,0,0,0,53,0,53,53,0,0,0,0,0,0,
0,53,0,0,0,0,53,0,53,53,0,0,0,0,0,0,
0,53,0,0,0,0,0,0,0,53,0,0,0,0,0,0,
0,53,0,0,0,0,0,0,0,53,0,0,0,0,0,0,
0,53,0,0,0,0,0,0,0,53,0,0,0,0,0,0
</Tiles>
<Tiles height="1">
0,0,0,0,0,0,0,0,0,0,0,0,0,0,0,0,
0,0,0,0,0,0,0,0,0,0,0,0,0,0,0,0,
0,0,0,0,0,0,0,0,0,0,0,0,0,0,0,0,
0,0,0,22,22,22,22,22,22,22,22,22,0,0,0,0,
0,0,23,0,0,0,0,0,0,0,0,0,0,0,0,0,
0,0,23,0,0,0,0,0,0,0,0,0,0,0,0,0,
0,0,23,0,0,21,0,0,0,0,0,0,0,0,0,0,
0,0,23,0,0,21,0,0,0,0,0,0,0,0,0,0,
0,0,23,0,0,21,0,0,0,0,0,0,0,0,0,0,
0,0,22&23,22,22,22&21,0,0,0,0,0,0,0,0,0,0,
0,23,0,0,0,0,21,22,0,0,0,0,0,0,0,0,
0,23,0,0,0,0,21&23,0,21,0,0,0,0,0,0,0,
0,23,0,0,0,0,22&21&23,22,22&21,0,0,0,0,0,0,0,
0,23,0,0,0,0,0,0,0,21,0,0,0,0,0,0,
0,23,0,0,0,0,0,0,0,21,0,0,0,0,0,0,
0,23,0,0,0,0,0,0,0,21,0,0,0,0,0,0
</Tiles>
<Tiles height="0">
0,0,0,0,0,0,0,0,0,0,0,0,0,0,0,0,
0,0,0,0,0,0,0,0,0,0,0,0,0,0,0,0,
0,0,0,0,0,0,0,0,0,0,0,0,0,0,0,0,
0,0,0,22,22,22,22,22,22,22,22,22,0,0,0,0,
0,0,23,1,1,1,1,1,1,1,1,1,0,0,0,0,
0,0,23,1,1,1,1,1,1,1,1,1,0,0,0,0,
0,0,23,1,1,21,0,0,0,0,0,0,0,0,0,0,
0,0,23,1,1,21,0,0,0,0,0,0,0,0,0,0,
0,0,23,1,1,21,0,0,0,0,0,0,0,0,0,0,
0,0,22&23,1&27,1&27,22&21,0,0,0,0,0,0,0,0,0,0,
0,23,1,1,1,1,21,49,0,0,0,0,0,0,0,0,
0,23,1,1,1,1,21&23,1,21,0,0,0,0,0,0,0,
0,23,1,1,1,1,22&21&23,1&27,22&21,0,0,0,0,0,0,0,
0,23,1,1,1,1,1,1,1,21,0,0,0,0,0,0,
0,23,1,1,1,1,1,1,1,21,0,0,0,0,0,0,
0,23,1,1,1,1,1,1,1,21,0,0,0,0,0,0
</Tiles>
</Chunk>
