<Chunk position="0,0">
	<Tiles height="-1">
		0,0,0,0,0,0,0,0,0,0,0,0,0,0,0,0,
		0,0,0,0,0,0,0,0,0,0,0,0,0,0,0,0,
		0,0,0,0,0,0,0,0,0,0,0,0,0,0,0,0,
		0,0,0,0,0,0,0,0,0,0,0,0,0,0,0,0,
		0,0,0,0,0,0,0,0,0,0,0,0,0,0,0,0,
		0,0,0,0,0,0,0,0,0,7,6,6,4,0,0,0,
		0,0,0,0,0,0,0,0,0,9,1,1,3,0,0,0,
		0,0,0,0,0,0,0,0,0,10,12,12,13,0,0,0,
		0,0,0,0,0,0,0,0,0,0,0,0,0,0,0,0,
		0,0,0,0,0,0,0,0,0,0,0,0,0,0,0,0,
		0,0,0,0,0,0,0,0,0,0,0,0,0,0,0,0,
		0,0,0,0,0,0,0,0,0,0,0,0,0,0,0,0,
		0,0,0,0,0,0,0,0,0,0,0,0,0,0,0,0,
		0,0,0,0,0,0,0,0,0,0,0,0,0,0,0,0,
		0,0,0,0,0,0,0,0,0,0,0,0,0,0,0,0,
		0,0,0,0,0,0,0,0,0,0,0,0,0,0,0,0
	</Tiles>
	<Tiles height="0">
		2,2,2,2,2,2,2,2,2,2,2,2,2,2,2,2,
		2,1,1,2,1,1,1,1,2,2,1,1,1,1,1,2,
		2,1,1,2,1,1,1,1,2,2,1,1,1,1,1,2,
		2,2,1,2,2,2,1,1,2,1,1,1,1,1,1,2,
		1,1,1,1,1,2,2,2,1,1,1,1,1,1,1,2,
		1,1,1,1,1,1,1,1,1,0,0,0,0,1,1,2,
		1,1,1,1,1,1,1,1,1,0,0,0,0,1,1,2,
		1,1,1,1,1,1,1,1,1,0,0,0,0,1,1,2,
		1,1,1,1,1,1,1,1,1,1,1,1,1,1,1,2,
		1,1,1,1,1,1,1,1,1,1,1,1,1,1,1,2,
		1,1,1,1,1,1,1,8,12,12,12,12,5,1,1,2,
		1,1,1,1,1,1,1,3,0,0,0,0,9,1,1,2,
		1,1,1,1,1,1,1,11,6,6,6,6,14,1,1,2,
		1,1,1,1,1,1,1,1,1,1,1,1,1,1,1,2,
		1,1,1,1,1,1,1,1,1,1,1,1,1,1,1,2,
		2,2,2,2,2,2,2,2,2,2,2,2,2,2,2,2
	</Tiles>
	<Tiles height="1">
		0,0,0,0,0,0,0,0,0,0,0,0,0,0,0,0,
		0,0,0,0,0,0,0,0,0,0,0,0,0,0,0,0,
		0,0,0,0,0,0,0,0,0,0,0,0,0,0,0,0,
		0,0,0,0,0,0,0,0,0,0,0,0,0,0,0,0,
		0,0,0,0,0,0,0,0,0,0,0,0,0,0,0,0,
		0,0,0,0,0,0,0,0,0,0,0,0,0,0,0,0,
		0,0,0,0,0,0,0,0,0,0,0,0,0,0,0,0,
		0,0,0,0,0,0,0,0,0,0,0,0,0,0,0,0,
		0,0,0,0,0,0,0,0,0,0,0,0,0,0,0,0,
		0,0,0,0,0,0,0,0,0,0,0,0,0,0,0,0,
		0,0,0,0,0,0,0,0,0,0,0,0,0,0,0,0,
		0,0,0,0,0,0,0,0,1,1,1,1,0,0,0,0,
		0,0,0,0,0,0,0,0,0,0,0,0,0,0,0,0,
		0,0,0,0,0,0,0,0,0,0,0,0,0,0,0,0,
		0,0,0,0,0,0,0,0,0,0,0,0,0,0,0,0,
		0,0,0,0,0,0,0,0,0,0,0,0,0,0,0,0
	</Tiles>
</Chunk>
<Chunk position="1,0">
	<Tiles height="0">
		2,2,2,2,2,2,2,2,2,2,2,2,2,2,2,2,
		2,1,1,1,1,1,1,1,2,2,1,1,1,1,1,1,
		2,1,1,1,1,1,1,1,2,2,1,1,1,1,1,1,
		2,1,1,1,2,2,2,2,2,1,1,1,1,1,1,1,
		2,1,1,2,2,2,2,2,2,1,1,1,1,1,1,1,
		2,1,1,2,1,1,1,1,2,2,1,1,1,1,1,1,
		2,2,2,2,1,1,1,1,2,2,2,1,1,1,1,1,
		2,8,12,12,12,12,5,1,1,2,2,1,1,1,1,1,
		2,3,0,0,0,0,9,1,1,2,2,1,1,1,1,1,
		2,3,0,0,0,0,9,1,2,2,1,1,1,1,1,1,
		2,3,0,0,0,7,14,2,2,2,1,1,1,1,1,1,
		2,3,0,0,0,9,2,2,2,1,1,1,1,1,1,1,
		2,11,6,6,6,14,1,2,2,2,2,2,1,1,1,1,
		2,1,1,1,1,1,1,1,1,1,2,1,1,1,1,1,
		2,1,1,1,1,1,1,1,1,1,2,2,1,1,1,1,
		2,2,2,2,2,2,2,2,2,2,2,2,2,2,2,2
	</Tiles>
	<Tiles height="1">
		0,0,0,0,0,0,0,0,0,0,0,0,0,0,0,0,
		0,0,0,0,0,0,0,0,0,0,0,0,0,0,0,0,
		0,0,0,0,0,0,0,0,0,0,0,0,0,0,0,0,
		0,0,0,0,0,0,0,0,0,0,0,0,0,0,0,0,
		0,0,0,0,0,0,0,0,0,0,0,0,0,0,0,0,
		0,0,0,0,0,0,0,0,0,0,0,0,0,0,0,0,
		0,0,0,0,0,0,0,0,0,0,0,0,0,0,0,0,
		0,0,0,0,0,0,0,0,0,0,0,0,0,0,0,0,
		0,0,1,1,1,1,0,0,0,0,0,0,0,0,0,0,
		0,0,8,12,5,1,0,0,0,0,0,0,0,0,0,0,
		0,0,3,0,9,0,0,0,0,0,0,0,0,0,0,0,
		0,0,11,6,14,0,0,0,0,0,0,0,0,0,0,0,
		0,0,0,0,0,0,0,0,0,0,0,0,0,0,0,0,
		0,0,0,0,0,0,0,0,0,0,0,0,0,0,0,0,
		0,0,0,0,0,0,0,0,0,0,0,0,0,0,0,0,
		0,0,0,0,0,0,0,0,0,0,0,0,0,0,0,0
	</Tiles>
	<Tiles height="2">
		0,0,0,0,0,0,0,0,0,0,0,0,0,0,0,0,
		0,0,0,0,0,0,0,0,0,0,0,0,0,0,0,0,
		0,0,0,0,0,0,0,0,0,0,0,0,0,0,0,0,
		0,0,0,0,0,0,0,0,0,0,0,0,0,0,0,0,
		0,0,0,0,0,0,0,0,0,0,0,0,0,0,0,0,
		0,0,0,0,0,0,0,0,0,0,0,0,0,0,0,0,
		0,0,0,0,0,0,0,0,0,0,0,0,0,0,0,0,
		0,0,0,0,0,0,0,0,0,0,0,0,0,0,0,0,
		0,0,0,0,0,0,0,0,0,0,0,0,0,0,0,0,
		0,0,0,0,0,0,0,0,0,0,0,0,0,0,0,0,
		0,0,0,1,0,0,0,0,0,0,0,0,0,0,0,0,
		0,0,0,0,0,0,0,0,0,0,0,0,0,0,0,0,
		0,0,0,0,0,0,0,0,0,0,0,0,0,0,0,0,
		0,0,0,0,0,0,0,0,0,0,0,0,0,0,0,0,
		0,0,0,0,0,0,0,0,0,0,0,0,0,0,0,0,
		0,0,0,0,0,0,0,0,0,0,0,0,0,0,0,0
	</Tiles>
</Chunk>
<Chunk position="2,0">
	<Tiles height="-1">
		0,0,0,0,0,0,0,0,0,0,0,0,0,0,0,0,
		0,0,0,0,0,0,0,0,0,0,0,0,0,0,0,0,
		0,0,0,0,0,0,0,0,0,0,0,0,0,0,0,0,
		0,0,0,0,0,0,0,0,0,0,0,0,0,0,0,0,
		0,0,0,0,0,0,0,0,0,0,0,0,0,0,0,0,
		0,0,0,0,0,0,0,0,0,7,6,6,4,0,0,0,
		0,0,0,0,0,0,0,0,0,9,1,1,3,0,0,0,
		0,0,0,0,0,0,0,0,0,10,12,12,13,0,0,0,
		0,0,0,0,0,0,0,0,0,0,0,0,0,0,0,0,
		0,0,0,0,0,0,0,0,0,0,0,0,0,0,0,0,
		0,0,0,0,0,0,0,0,0,0,0,0,0,0,0,0,
		0,0,0,0,0,0,0,0,0,0,0,0,0,0,0,0,
		0,0,0,0,0,0,0,0,0,0,0,0,0,0,0,0,
		0,0,0,0,0,0,0,0,0,0,0,0,0,0,0,0,
		0,0,0,0,0,0,0,0,0,0,0,0,0,0,0,0,
		0,0,0,0,0,0,0,0,0,0,0,0,0,0,0,0
	</Tiles>
	<Tiles height="0">
		2,2,2,2,2,2,2,2,2,2,2,2,2,2,2,2,
		1,1,1,2,1,1,1,1,2,2,1,1,1,1,1,2,
		1,1,1,2,1,1,1,1,2,2,1,1,1,1,1,2,
		1,1,1,2,2,2,1,1,2,1,1,1,1,1,1,2,
		1,1,1,1,1,2,2,2,1,1,1,1,1,1,1,2,
		1,1,1,1,1,1,1,1,1,0,0,0,0,1,1,2,
		1,1,1,1,1,1,1,1,1,0,0,0,0,1,1,2,
		1,1,1,1,1,1,1,1,1,0,0,0,0,1,1,2,
		1,1,1,1,1,1,1,1,1,1,1,1,1,1,1,2,
		1,1,1,1,1,1,1,1,1,1,1,1,1,1,1,2,
		1,1,1,1,1,1,1,8,12,12,12,12,5,1,1,2,
		1,1,1,1,1,1,1,3,0,0,0,0,9,1,1,2,
		1,1,1,1,1,1,1,11,6,6,6,6,14,1,1,2,
		1,1,1,1,1,1,1,1,1,1,1,1,1,1,1,2,
		1,1,1,1,1,1,1,1,1,1,1,1,1,1,1,2,
		2,2,2,2,2,2,2,2,2,2,2,2,2,2,2,2
	</Tiles>
	<Tiles height="1">
		0,0,0,0,0,0,0,0,0,0,0,0,0,0,0,0,
		0,0,0,0,0,0,0,0,0,0,0,0,0,0,0,0,
		0,0,0,0,0,0,0,0,0,0,0,0,0,0,0,0,
		0,0,0,0,0,0,0,0,0,0,0,0,0,0,0,0,
		0,0,0,0,0,0,0,0,0,0,0,0,0,0,0,0,
		0,0,0,0,0,0,0,0,0,0,0,0,0,0,0,0,
		0,0,0,0,0,0,0,0,0,0,0,0,0,0,0,0,
		0,0,0,0,0,0,0,0,0,0,0,0,0,0,0,0,
		0,0,0,0,0,0,0,0,0,0,0,0,0,0,0,0,
		0,0,0,0,0,0,0,0,0,0,0,0,0,0,0,0,
		0,0,0,0,0,0,0,0,0,0,0,0,0,0,0,0,
		0,0,0,0,0,0,0,0,1,1,1,1,0,0,0,0,
		0,0,0,0,0,0,0,0,0,0,0,0,0,0,0,0,
		0,0,0,0,0,0,0,0,0,0,0,0,0,0,0,0,
		0,0,0,0,0,0,0,0,0,0,0,0,0,0,0,0,
		0,0,0,0,0,0,0,0,0,0,0,0,0,0,0,0
	</Tiles>
</Chunk>
<Chunk position="2,2">
	<Tiles height="-1">
		0,0,0,0,0,0,0,0,0,0,0,0,0,0,0,0,
		0,0,0,0,0,0,0,0,0,0,0,0,0,0,0,0,
		0,0,0,0,0,0,0,0,0,0,0,0,0,0,0,0,
		0,0,0,0,0,0,0,0,0,0,0,0,0,0,0,0,
		0,0,0,0,0,0,0,0,0,0,0,0,0,0,0,0,
		0,0,0,0,0,0,0,0,0,7,6,6,4,0,0,0,
		0,0,0,0,0,0,0,0,0,9,1,1,3,0,0,0,
		0,0,0,0,0,0,0,0,0,10,12,12,13,0,0,0,
		0,0,0,0,0,0,0,0,0,0,0,0,0,0,0,0,
		0,0,0,0,0,0,0,0,0,0,0,0,0,0,0,0,
		0,0,0,0,0,0,0,0,0,0,0,0,0,0,0,0,
		0,0,0,0,0,0,0,0,0,0,0,0,0,0,0,0,
		0,0,0,0,0,0,0,0,0,0,0,0,0,0,0,0,
		0,0,0,0,0,0,0,0,0,0,0,0,0,0,0,0,
		0,0,0,0,0,0,0,0,0,0,0,0,0,0,0,0,
		0,0,0,0,0,0,0,0,0,0,0,0,0,0,0,0
	</Tiles>
	<Tiles height="0">
		2,2,2,2,2,2,2,2,2,2,2,2,2,2,2,2,
		1,1,1,2,1,1,1,1,2,2,1,1,1,1,1,2,
		1,1,1,2,1,1,1,1,2,2,1,1,1,1,1,2,
		1,1,1,2,2,2,1,1,2,1,1,1,1,1,1,2,
		1,1,1,1,1,2,2,2,1,1,1,1,1,1,1,2,
		1,1,1,1,1,1,1,1,1,0,0,0,0,1,1,2,
		1,1,1,1,1,1,1,1,1,0,0,0,0,1,1,2,
		1,1,1,1,1,1,1,1,1,0,0,0,0,1,1,2,
		1,1,1,1,1,1,1,1,1,1,1,1,1,1,1,2,
		1,1,1,1,1,1,1,1,1,1,1,1,1,1,1,2,
		1,1,1,1,1,1,1,8,12,12,12,12,5,1,1,2,
		1,1,1,1,1,1,1,3,0,0,0,0,9,1,1,2,
		1,1,1,1,1,1,1,11,6,6,6,6,14,1,1,2,
		1,1,1,1,1,1,1,1,1,1,1,1,1,1,1,2,
		1,1,1,1,1,1,1,1,1,1,1,1,1,1,1,2,
		2,2,2,2,2,2,2,2,2,2,2,2,2,2,2,2
	</Tiles>
	<Tiles height="1">
		0,0,0,0,0,0,0,0,0,0,0,0,0,0,0,0,
		0,0,0,0,0,0,0,0,0,0,0,0,0,0,0,0,
		0,0,0,0,0,0,0,0,0,0,0,0,0,0,0,0,
		0,0,0,0,0,0,0,0,0,0,0,0,0,0,0,0,
		0,0,0,0,0,0,0,0,0,0,0,0,0,0,0,0,
		0,0,0,0,0,0,0,0,0,0,0,0,0,0,0,0,
		0,0,0,0,0,0,0,0,0,0,0,0,0,0,0,0,
		0,0,0,0,0,0,0,0,0,0,0,0,0,0,0,0,
		0,0,0,0,0,0,0,0,0,0,0,0,0,0,0,0,
		0,0,0,0,0,0,0,0,0,0,0,0,0,0,0,0,
		0,0,0,0,0,0,0,0,0,0,0,0,0,0,0,0,
		0,0,0,0,0,0,0,0,1,1,1,1,0,0,0,0,
		0,0,0,0,0,0,0,0,0,0,0,0,0,0,0,0,
		0,0,0,0,0,0,0,0,0,0,0,0,0,0,0,0,
		0,0,0,0,0,0,0,0,0,0,0,0,0,0,0,0,
		0,0,0,0,0,0,0,0,0,0,0,0,0,0,0,0
	</Tiles>
</Chunk>
<Chunk position="2,1">
	<Tiles height="-1">
		0,0,0,0,0,0,0,0,0,0,0,0,0,0,0,0,
		0,0,0,0,0,0,0,0,0,0,0,0,0,0,0,0,
		0,0,0,0,0,0,0,0,0,0,0,0,0,0,0,0,
		0,0,0,0,0,0,0,0,0,0,0,0,0,0,0,0,
		0,0,0,0,0,0,0,0,0,0,0,0,0,0,0,0,
		0,0,0,0,0,0,0,0,0,7,6,6,4,0,0,0,
		0,0,0,0,0,0,0,0,0,9,1,1,3,0,0,0,
		0,0,0,0,0,0,0,0,0,10,12,12,13,0,0,0,
		0,0,0,0,0,0,0,0,0,0,0,0,0,0,0,0,
		0,0,0,0,0,0,0,0,0,0,0,0,0,0,0,0,
		0,0,0,0,0,0,0,0,0,0,0,0,0,0,0,0,
		0,0,0,0,0,0,0,0,0,0,0,0,0,0,0,0,
		0,0,0,0,0,0,0,0,0,0,0,0,0,0,0,0,
		0,0,0,0,0,0,0,0,0,0,0,0,0,0,0,0,
		0,0,0,0,0,0,0,0,0,0,0,0,0,0,0,0,
		0,0,0,0,0,0,0,0,0,0,0,0,0,0,0,0
	</Tiles>
	<Tiles height="0">
		2,2,2,2,2,2,2,2,2,2,2,2,2,2,2,2,
		1,1,1,2,1,1,1,1,2,2,1,1,1,1,1,2,
		1,1,1,2,1,1,1,1,2,2,1,1,1,1,1,2,
		1,1,1,2,2,2,1,1,2,1,1,1,1,1,1,2,
		1,1,1,1,1,2,2,2,1,1,1,1,1,1,1,2,
		1,1,1,1,1,1,1,1,1,0,0,0,0,1,1,2,
		1,1,1,1,1,1,1,1,1,0,0,0,0,1,1,2,
		1,1,1,1,1,1,1,1,1,0,0,0,0,1,1,2,
		1,1,1,1,1,1,1,1,1,1,1,1,1,1,1,2,
		1,1,1,1,1,1,1,1,1,1,1,1,1,1,1,2,
		1,1,1,1,1,1,1,8,12,12,12,12,5,1,1,2,
		1,1,1,1,1,1,1,3,0,0,0,0,9,1,1,2,
		1,1,1,1,1,1,1,11,6,6,6,6,14,1,1,2,
		1,1,1,1,1,1,1,1,1,1,1,1,1,1,1,2,
		1,1,1,1,1,1,1,1,1,1,1,1,1,1,1,2,
		2,2,2,2,2,2,2,2,2,2,2,2,2,2,2,2
	</Tiles>
	<Tiles height="1">
		0,0,0,0,0,0,0,0,0,0,0,0,0,0,0,0,
		0,0,0,0,0,0,0,0,0,0,0,0,0,0,0,0,
		0,0,0,0,0,0,0,0,0,0,0,0,0,0,0,0,
		0,0,0,0,0,0,0,0,0,0,0,0,0,0,0,0,
		0,0,0,0,0,0,0,0,0,0,0,0,0,0,0,0,
		0,0,0,0,0,0,0,0,0,0,0,0,0,0,0,0,
		0,0,0,0,0,0,0,0,0,0,0,0,0,0,0,0,
		0,0,0,0,0,0,0,0,0,0,0,0,0,0,0,0,
		0,0,0,0,0,0,0,0,0,0,0,0,0,0,0,0,
		0,0,0,0,0,0,0,0,0,0,0,0,0,0,0,0,
		0,0,0,0,0,0,0,0,0,0,0,0,0,0,0,0,
		0,0,0,0,0,0,0,0,1,1,1,1,0,0,0,0,
		0,0,0,0,0,0,0,0,0,0,0,0,0,0,0,0,
		0,0,0,0,0,0,0,0,0,0,0,0,0,0,0,0,
		0,0,0,0,0,0,0,0,0,0,0,0,0,0,0,0,
		0,0,0,0,0,0,0,0,0,0,0,0,0,0,0,0
	</Tiles>
</Chunk>